00000000111100000111111111000000000000000
00000000000000001111111111000000000000000
11000000000000011111111111110000000000000
11100000000000111111111111111000000000000
11111000000001111111111111111110000000000
11111111111111111111111111111111111111111
11111111111111111111111111111111111111111